IN_CheckEqSStartStateInactive = State("IN_Check=S(Inactive", "edcfd7", "‚Üß=‚Çç")
CheckEqSEndStateInactive = State("Check=S)Inactive", "edcfd7", "‚Üß=‚Çé")
IN_CheckEqSAnyInactive = State("IN_Check=S*Inactive", "edcfd7", "‚Üß‚©Æ")
RowSignalPositiveInactive = State("RowSignalPositiveInactive", "9EA9A4", "‚äù")
CheckEqSAny = State("Check=S*", "F5A3AB", "‚Üß‚©Æ")
CheckEqSEndState = State("Check=S)", "F5A3AB", "‚Üß=‚Çé")
CheckEqSStartState = State("Check=S(", "F5A3AB", "‚Üß=‚Çç")
TrapDoorInactive = State("TrapDoorInactive", "780000", "TD")
SignalTransmitterTurnUpActive = State("SignalTransmitterTurnUpActive", "2A9D8F", "‚Æ≤")
EndCapDoorHandleWestActive = State("EndCapDoorHandleWestActive", "2A9D8F", "‚ó®üîì")
SignalTransmitterTurnUpInactive = State("SignalTransmitterTurnUpInactive", "9EA9A4", "‚Æ≤")
RowSignalPositiveStartInactive = State("RowSignalPositiveStartInactive", "F7EF99", "‚äù")
RowSignalPositiveWaiting = State("RowSignalPositiveWaiting", "F7EF99", "‚è±")
RowSignalPositiveStartWaiting = State("RowSignalPositiveStartWaiting", "F7EF99", "‚äù‚è±")
SignalTransmitterTurnDownInactive = State("SignalTransmitterTurnDownInactive", "9EA9A4", "‚ÆÆ")
RowSignalPositiveFullAccept = State("RowSignalPositiveFullAccept", "0a9396", "‚úÖ")
SignalTransmitterTurnDownActive = State("SignalTransmitterTurnDownActive", "2A9D8F", "‚ÆÆ")
StartStateEqSStartState = State("(=S(", "F5A3AB", "‚Üß‚Çç=‚Çç")
EndStateEqSEndState = State(")=S)", "F5A3AB", "‚Üß‚Çé=‚Çé")
AnyEqSAny = State("*=S*", "F5A3AB", "‚Üß*‚©Æ")
RowSignalPositiveInterimAccept = State("RowSignalPositiveInterimAccept", "90be6d", "‚úÖ")
SignalDoorHandleOpen = State("SignalDoorHandleOpen", "2A9D8F", "üóù")
SignalDoorOpen = State("SignalDoorOpen", "2A9D8F", "üîì‚ñ¶")
EndCapDoorHandleWestInactive = State("EndCapDoorHandleWestInactive", "9EA9A4", "‚ó®üîí")
EndCapDoorHandleWestActive = State("EndCapDoorHandleWestActive", "2A9D8F", "‚ó®üîì")
EndCapDoorWestHandleStop = State("EndCapDoorWestHandleStop", "C1121F", "‚ó®üîí")
EndcapDoorWestInactive = State("EndcapDoorWestInactive", "9EA9A4", "‚ó®")
EndcapDoorWestActive = State("EndcapDoorWestActive", "2A9D8F", "‚ó®")
EndcapDoorWestStop = State("EndcapDoorWestStop", "C1121F", "‚ó®")
WestWire = State("WestWire", "wire_color", "ü°∏")
EndcapDSOpen = State("EndcapDSOpen", "Fdf0d5", "(")
1 = State("1", "Fdf0d5", "‚ë†")
2 = State("2", "Fdf0d5", "‚ë°")
3 = State("3", "Fdf0d5", "‚ë¢")
EndcapDSClosed = State("EndcapDSClosed", "Fdf0d5", ")")
EndcapDoorWestReset = State("EndcapDoorWestReset", "reset_color", "‚Ü∫‚ó®")
EndCapDoorHandleWestReset = State("EndCapDoorHandleWestReset", "reset_color", "‚Ü∫‚ó®üîí")
SignalDoorReset = State("SignalDoorReset", "reset_color", "‚Ü∫‚ñ¶")
SignalDoorResetWalk = State("SignalDoorResetWalk", "reset_color", "‚Ü∫‚ñ¶‚óÉ")
EndcapDoorWestResetWaiting = State("EndcapDoorWestResetWaiting", "reset_color", "‚Ü∫‚è±‚ó®")
SignalTransmitterTurnDownReset = State("SignalTransmitterTurnDownReset", "reset_color", "‚Ü∫‚ÆÆ")
SignalTransmitterTurnUpReset = State("SignalTransmitterTurnUpReset", "reset_color", "‚Ü∫‚Æ≤")
EndCapDoorHandleWestResetWaiting = State("EndCapDoorHandleWestResetWaiting", "reset_color", "‚Ü∫‚è±‚ó®üîí")
RowSignalPositiveReset = State("RowSignalPositiveReset", "reset_color", "‚Ü∫")
SignalDoorHandleReset = State("SignalDoorHandleReset", "reset_color", "‚Ü∫üóù")
SignalDoorSendConfirmedTransmission = State("SignalDoorSendConfirmedTransmission", "reset_color", "‚ñ¶‚áâ‚úÖ")
ResetConfirmedTransmissionWest = State("ResetConfirmedTransmissionWest", "reset_color", "‚Ü∫‚úÖ‚áâ")
LockedSignalDoorHandleInactive = State("LockedSignalDoorHandleInactive", "9EA9A4", "üóù")
LockedSignalDoorInactive = State("LockedSignalDoorInactive", "9EA9A4", "üîí‚ñ¶")
